@@@@@@@@@@@@@##################@@@@@@@@@@@@@@@@@@@@@
@@@@@@@@@@@@############################@@@@@@@@@@@@
@@@@@@##########################################@@@@
@@@##########################################@@@@@@@
@#############################################@@@@@@
##########################################@@####@@@@
@@@@@##########################################@@@##
@@@@@###########################################@@##
@@@############################################@@@@@
@@@@###########################################@@@@@
@@@@@@@@@@############################@@@@@@@@@@@@@@
@@@@@@@####################################@@@@@@@@@
@@@@@@@@@@@@@@@@################@@@@@@@@@@@@@@@@@@@@
@@@@@@@@@@@@@@@@@@@@@@@@@@@@@@@@@@@@@@@@@@@@@@@@@@@@
