,,,,,,,,,,,,,$$$$$$$$$$$$$$$$$$,,,,,,,,,,,,,,,,,,,,,
,,,,,,,,,,,,$,,,,,,,,,,,,,,,,,$$$$$$$$$$,,,,,,,,,,,,
,,,,,,$$$$$$$,,,,,,,,,,,,,,,,,,,,,,,,,,,$$$$$$$$$,,,
,,,$,,,,,,,,,,,,,,,,,,,,,,,,,,,,,,,,,,,,,,,,$,,,,,,,
,$$,,,,,,,,,,,,,,,,,,,,,,,,,,,,,,,,,,,,,,,$$$$,,,,,,
$$$$$$,,,,,,,,,,,,,,,,,,,,,,,,,,,,,,,,,,,$,,$,,$,,,,
,,,,,$,,,,,,,,,,,,,,,,,,,,,,,,,,,,,,,,,,,,$$,,$,,,,,
,,,,,$,,,,,,,,,,,,,,,,,,,,,,,,,,,,,,,,,,,,,,,,,$,,,,
,,,$$,,,,,,,,,,,,,,,,,,,,,,,,,,,,,,,,,,,,,,,,,$,,,,,
,,,,$$$,,,,,,,,,,,,,,,,,,,,,,,,,,,,,,,$$$$$$$$$,,,,,
,,,,,,,,,,$,,,,,,,,,,,,,,,,,,,,,,,,,,$,,,,,,,,,,,,,,
,,,,,,,$$$$$$$$$$,,,,,,,,,,,,,,,$$$$$$$$$$$$,,,,,,,,
,,,,,,,,,,,,,,,,$$$$$$$$$$$$$$$$,,,,,,,,,,,,,,,,,,,,
,,,,,,,,,,,,,,,,,,,,,,,,,,,,,,,,,,,,,,,,,,,,,,,,,,,,