$$$$$$$$$$$$$$$$$$$$$$$$$$$$$$$$$$$$$$$$$$$$$$$$$$$$$$
$,,,,,,,,,,,,,$$$$$$$$$$$$$$$$$$,,,,,,,,,,,,,,,,,,,,,$
$,,,,,,,,,,,,$,,,,,,,,,,,,,,,,,$$$$$$$$$$,,,,,,,,,,,,$
$,,,,,,$$$$$$$,,,,,,,,,,,,,,,,,,,,,,,,,,,$$$$$$$$$,,,$
$,,,$,,,,,,,,,,,,,,,,,,,,,,,,,,,,,,,,,,,,,,,,$,,,,,,,$
$,$$,,,,,,,,,,,,,,,,,,,,,,,,,,,,,,,,,,,,,,,$$$$,,,,,,$
$$$$$$$,,,,,,,,,,,,,,,,,,,,,,,,,,,,,,,,,,,$,,$,,$,,,,$
$,,,,,$,,,,,,,,,,,,,,,,,,,,,,,,,,,,,,,,,,,,$$,,$,,,,,$
$,,,,,$,,,,,,,,,,,,,,,,,,,,,,,,,,,,,,,,,,,,,,,,,$,,,,$
$,,,$$,,,,,,,,,,,,,,,,,,,,,,,,,,,,,,,,,,,,,,,,,$,,,,,$
$,,,,$$$,,,,,,,,,,,,,,,,,,,,,,,,,,,,,,,$$$$$$$$$,,,,,$
$,,,,,,,,,,$,,,,,,,,,,,,,,,,,,,,,,,,,,$,,,,,,,,,,,,,,$
$,,,,,,,$$$$$$$$$$,,,,,,,,,,,,,,,$$$$$$$$$$$$,,,,,,,,$
$,,,,,,,,,,,,,,,,$$$$$$$$$$$$$$$$,,,,,,,,,,,,,,,,,,,,$
$$$$$$$$$$$$$$$$$$$$$$$$$$$$$$$$$$$$$$$$$$$$$$$$$$$$$$